[Intro/Verse]

(these are the root notes, bass players with John use the optional verse with pentatonic riffs)

G|---------------------------------------------------------------------------|
D|---------------------------------------------------------------------------|
A|--4---4------------4---4------------4---4------------4---4-----------------|
E|--------5---0------------5---0------------5---0------------5---0-----------|

[Optional Intro/Verse]

G|---------------------------------------------------------------------------|
D|---------------------------------------------------------------------------|
A|--4----4--6----------------------------------------------------------------|
E|-------------5--7--0-------------------------------------------------------|

"We going down"

G|---------------------------------------------------------------------------|
D|---------------------------------------------------------------------------|
A|-----2--2--2--2--4---4-----------------------------------------------------|
E|-----------------------5-----0---------------------------------------------|
